00000000000000000000000000000000
00000000000000000000000000000000
11111100001111111111110000111111
00000000000000000000000000000000
00000000000000000000000000000000
00001111111100000000111111110000
11000000000000111100000000000011
00000000000000000000000000000000
00000000000000000000000000000000
11111100001111111111110000111111
00000000000000000000000000000000
00000000000000000000000000000000
11111111111111111111111111111111